1111
1E01
1C01
1101
1P01
1001
1C01
1111