1111
1E01
10C1
1011
1P01
1001
1001
1111