1111
1N01
1001
1EP1
1CC1
1111
